##############################
##************##************##
##*####*#####*##*#####*####*##
##*####*#####*##*#####*####*##
##**************************##
##*####*##*########*##*####*##
##*####*##*########*##*####*##
##******##****##****##******##
#######*#####*##*#####*#######
#######*#####*##*#####*#######
#######*##**********##*#######
#######*##*########*##*#######
#######*##*########*##*#######
***********#******#***********
#######*##*########*##*#######
#######*##*########*##*#######
#######*##**********##*#######
#######*##*########*##*#######
#######*##*########*##*#######
##************##************##
##*####*#####*##*#####*####*##
##*####*#####*## #####*####*##
##***##****************##***##
####*##*##*########*##*##*####
####*##*##*########*##*##*####
##******##****##****##******##
##*##########*##*##########*##
##*##########*##*##########*##
##**************************##
##############################